--------------------------------------------------------------------------------------------------------------------------------------------------------------------------------------------------------
--------------------------------------------------------------------------------------------------------------------------------------------------------------------------------------------------------
--------------------------------------------------------------------------------------------------------------------------------------------------------------------------------------------------------
--------------------------------------------------------------------------------------------------------------------------------------------------------------------------------------------------------
--------------------------------------------------------------------------------------------------------------------------------------------------------------------------------------------------------
--------U-------S-S--------SU-U--------S--S-----------------US----------------US------UUSS---------------------S--S--------------------------S-US-------------------------------------------------------
-------------------------------C---------------------------C------C-------------------------------C-C-C-C-C-------------C------------------------C------------------------------------------------------
--------------------------------------------------------------------------------------------------------------------------------------------------------------------------------------------------------
--------------------------------------------------------------------------------------------------------------------------------------------------------------------------------------------------------
--------------------------------------------------------------------------------------------------------------------------------------------------------------------------------------------------------
-#------C----C-#---tt--tt---C-CS--tt-tt----tt---C---#C#ttU-SC-U--US-----S-----C---tt--CC----tt--C-SSSSSSSSSS-----------SSC#-----#---------Ctt-CC-S--------------------------------tt--------------------
-#-------------#---tttttt--------#tt-tt----tt-------#-#tt-----------------tt----tttt--------tt---#------------------------#---#-#----------tt-------------------------------------tt--------------------
-#-tt-tt-tt----#---tttttt#-------#tt-tt----tt-tt--tt#-#tt-----------------tt#---tttt#-------tt---#------------------------#--##-#-tt-------tt-------------------------------------tt--------------------
##-ttgtt-tt-k-g#gk-tttttt#------##tt#ttg-g-tt-tt--tt#-#tt-g----g------#---tt##--tttt#-----g-tt---#----------kg-g--g---g---#-###k#-tt-----g-tt---g--ggggggggggggg-g%gggggggg%ggggggttgggggg-g-g-ggggggggF
||-|||||%||%|%||||%|||||||%%%%%%||||||||%|%||%||%%|||%|||%|%%%%|-%%%%%|%%%||||%-|||||%%%-%|%||--%|%%%%%%%%%%||%|%%|%%%|%%%|%|||||%||%-%%%|%||%%%|%%|||||||||||||-|||||||||||||||||||||||||%|%|%||||||||%
||-|||||||||||||||||||||||||||||||||||||||||||||||||||||||||||||-||||||||||||||-||||||||-|||||--|||||||||||||||||||||||||||||||||||||-||||||||||||||||||||||||||-|||||||||||||||||||||||||||||||||||||||
