--------------------------------------------------------------------------------------------------------------------------------------------------------------------------------------------------------
--------------------------------------------------------------------------------------------------------------------------------------------------------------------------------------------------------
--------------------------------------------------------------------------------------------------------------------------------------------------------------------------------------------------------
--------------------------------------------------------------------------------------------------------------------------------------------------------------------------------------------------------
--------------------------------------------------------------------------------------------------------------------------------------------------------------------------------------------------------
---S-------------S----SS---U--------------S-----------S--------------S---U----------------S-----------U--S--------------------------------------------------------------S-----S-S-----------------------
----------------------------------C----------------C---------------------------------------C--------------C---------------------------------------------------------------------------------------------
--------------------------------------------------------------------------------------------------------------------------------------------------------------------------------------------------------
--------------------------------------------------------------------------------------------------------------------------------------------------------------------------------------------------------
--------------------------------------------------------------------------------------------------------------------------------------------------------------------------------------------------------
--------------tt--------US-C#--C--S-C-tt----------#SU------------tt-S--U-C-------CS--------S----------CC--S#------Stt--------------------------------------------S--------------------------------------
--------------tt----------#-#tt-------tt----------#--------------tt-----#--------------------##------------#-------tt-----------------------------------------------------------------------------------
--------tt----tt----tt----#-#tt-------tttt---tt---#--------------tt---#-#--------------------##---------#--#-------tt-----------------------------------------------------------------------------------
g-#-#-g#tt#k--tt#--gtt----#-#tt--g----tttt-k#tt-g-#-----k-k--k-g-tt---#-#-kk-g--g--#-k-g-g--###k-g-k-k--#--#k-g----tt#g-k-k-g-g-g-----------%-----------#----------------------------------------------F
|%|-|-||||||%%|||-%|||-%%%|%|||%%|%%%%||||%||||%|%|%%%%%|%|%%|%|%||%%-|%|%||%|%%|%%|-|%|%|-%||||%|%|%|%%|%%||%|%%%%||||%|%|%|%|%|%%%--------|---%-------|--------%------%---%---------------------%----%
|||-|-|||||||||||-||||-||||||||||||||||||||||||||||||||||||||||||||||-||||||||||||||-|||||-|||||||||||||||||||||||||||||||||||||||||--------|---|-------|--------|------|---|---------------------|----|
