---------------
---------------
---------------
---------------
-D---------o-*D
-D---------D--D
-D------------D
-D*----o------D
-D-----D------D
-D---o-------*D
-D---D--------D
-D*------o----D
-D-------D----D
-------r------D
X---X--X--X---X
X---X--X--X---X