---------------
---------------
---------------
---------------
---------------
---------------
---------------
---------------
---------------
---------------
-------o-----*D
-------o----ooD
o------o----DDD
o------g-----*D
X------X-----XX
X------X-----XX