--------------D
--------------D
--------------D
--------------D
--------------D
-oo-----------D
--------------D
--------------D
-DD--oo--------
-D*------------
-D*----------o-
-D----g------o-
-D---DD------o-
-D*----------g-
-D----------DD-
-D-------------
