----D--*---D---
----D-*-*--D---
----D*-*-*-D---
----DDDDDDDD---
DD------------D
--------------D
D*-oo----oo---D
--------------D
D*-----------DD
---oo----oo---D
D*------------D
-------------DD
---TT----TT----
---tt-D--tt----
---tt-D--tt----
---tt-D--tt----
