---------------
-------o-------
-------o-------
-------o-------
-------o-------
------*D*------
-------*-------
------*D*------
-TT-TTDDDTT-TT-
-DDDDDD--DDDDD-
---------------
---------------
---------------
---------------
---------------
---------------