---------------
---------------
---------------
-------------D-
------------DD-
-o-------oo--D-
-o-------TT--D-
-o-------tt--D-
-o--oo-------D-
-o--TT-------D-
-o--tt---oo--D-
-o-------TT--D-
---------tt--D-
-----g---tt--D-
X---XX-X--XX-XX
X---XX-X--XX-XX