---------------
---------------
---------------
---------------
---------------
---------------
---------------
---------------
---------------
-------o-------
-------o-------
----o--o--o----
---o-------o---
-------r-------
X------X-----TT
X------X-----tt