-D-------------
-D-------------
-D-------------
-D-------------
-D-------------
-D-------------
-D-------------
-D-------------
-DDDDDDDDDDDDDD
-------------D-
-------------*-
---------------
Xoooooooooooo*X
X---y--y--y---X
XXXXXXXXXXXXXXX
XXXXXXXXXXXXXXX