---------------
---------------
---------------
--------oo---oo
--------YY---YY
-DDD----DD---DD
------------o--
------------o--
------------o--
------D-----D--
---------------
---------------
---------------
---------------
---------------
---------------