-D-------------
-D-------------
-D-------------
-D-------------
-D-------------
-D-------------
-D-------------
-D-------------
-DDDDDDDDDDD---
---------------
---------------
-----o--------Y
-----o--------Y
-----o-----Dy-D
X----X-----XXXX
X----X-----XXXX