---------------
---------------
---------------
---------------
---------------
---------------
---------------
-D----y---y---Y
-DDTTDDDTTDDTTD
---tt---tt--tt-
---tt---tt--tt-
---tt---tt--tt-
---tt---tt--tt-
---tt---tt--tt-
---tt---tt--tt-
---tt---tt--tt-