---------------
---------------
---------------
---------o-----
--------o------
-------o-------
-------#-------
------##-------
------##-------
---o--##-------
---#--##-------
--##--##-------
--##--##----F--
#-##--##----#--
X-XX--XXXXXXXXX
X-XX--XXXXXXXXX