---------------
---------------
--g------------
-%%%%----------
-||------------
-||----g-------
-||---%%%%-----
-||---o||o-----
-||---o||o-----
-||---o||o-----
-||---%%%%-----
-||----||------
-||----||------
-||----||--g--g
-||----||-XXXXX
-||----||-XXXXX