---------------
---------------
---------------
---------------
---------------
---------------
---------------
---------------
------o--------
-----o-o-------
----o-o-o------
---o-o-o-o-----
D-----|-------D
X-k---|----k--X
XXXXXXXXXXXXXXX
XXXXXXXXXXXXXXX