---------------
---------------
---------------
---------------
---------------
---------------
---------------
---------------
-------D-------
--SSS@SSSS---D-
---------S---D-
----------SSSD-
--oo-------ooD-
--oo--g----ooD-
XXXXXXXXXXXXXXX
XXXXXXXXXXXXXXX