---------------
---------------
---------------
---------------
---------------
---------------
---------------
---------------
---------------
---------------
---------------
--2122222222X--
------ooooooX--
--g--gooooooX--
XXXXXXXXXXXXXXX
XXXXXXXXXXXXXXX