------U--------
---------------
------D--------
--------D------
------D--------
--------D------
------D--------
---r------r----
%%%%%%%%%%%%%%%
%%%%%%%%%%%%%%%
-------||------
-------||------
-------||------
-------||------
-------||------
-------||------