-D------------D
-D------------D
-D------------D
-DD----*----DD-
-------D-------
-------D-------
-XXXXXXXXXXXXX-
---------------
---------------
---------------
---------------
---------------
---------------
---------------
---------------
---------------