-------D-------
-------D-------
-------D-------
-------D-------
-------D-------
-XXXX--D-------
-XXXX--Dg-g----
-DX-----DDDDD--
-D*------------
-DX------------
-DX*---------D-
-DX------ooooD-
-D*------ooooD-
DDDDDDDDDDDDDDD
---------------
---------------