---------------
---------------
---------------
---------------
---------------
---------------
---------------
---------------
---------------
---------------
---------------
---------------
-D-----*-----D-
-D-----D-----D-
XXXXXXXXXXXXXXX
XXXXXXXXXXXXXXX