---------------
---------------
---------------
---------------
---------------
---------------
---------------
--------------D
---------------
-------o----D--
-------o-------
-------o------D
-------o------D
D------r------D
XXX----D----XXX
XXX---------XXX