---------------
---------------
---------------
---------------
---------------
--------------X
--------------X
-------------XX
-XXX--XXXXX-XXX
-XXX--XXXXX-XXX
-------------oX
X------------oX
X------------oX
--------g----oX
XXXX--XXXXX-XXX
XXXX--XXXXX-XXX