----------D----
----------D----
---g------D----
-DDDDD----D----
-DDDDD----D----
-D---D----D----
-D---D---oD----
-D---D---oD----
-D---D---oD----
-D---D---oD----
-D---D---oD----
-D---D---------
-D---D---------
-D---DTT-------
XXXXXXttXXXXXXX
XXXXXXttXXXXXXX