---------D-----
---------D-----
---------D-----
-DDTT------k-k-
-DDtt--TT-DDDDD
---tt--tt------
---tt--tt------
---tt--tt------
---tt--tt------
---tt--tt------
---tt--tt------
---tt--tt------
---tt--tt------
---tt--tt------
---tt--tt------
---tt--tt------