---------------
---------------
---------------
---------------
---------------
---------------
---------------
---------------
---------------
--------------X
------TT-----XX
-----otto-----X
-----otto-----X
X-X--otto--X-X-
XXXXXXXXXXXXXXX
XXXXXXXXXXXXXXX