---------------
---------------
---------------
---------------
---------------
--------------D
---------------
---------------
----------TT---
----------tt---
------TToott---
------ttoott---
------ttoott---
------ttggtt---
XXXXXXXXXXXXXXX
XXXXXXXXXXXXXXX