---------------
---------------
---------------
---------------
--------------g
------------DDD
----------TTDD-
----------tt---
----g-g---tt---
XXXXXXXTTXXXXXX
XXXXXXXttXXXXXX
-------tt------
-------tt------
-------tt------
-------tt------
-------tt------
