----------D----
----------D----
----------D----
---#-----oD----
-###-----oD----
-----#--y------
-----#####-----
---------------
---------#g-g--
---------######
---------------
---------------
---------------
---------------
---------------
---------------