---------------
-------o-------
---------------
---#---y---#---
###############
--------------#
#---y-----y---#
###############
--------------#
#---y-----y---#
###############
---------------
---------------
---------------
---------------
---------------