--D---------D--
--D---------D--
--D---------D--
--D---------D--
--D---------D--
--D---------D--
--D---------D--
--D---------D--
--D---------D--
--DDDDDDDDDDD--
---------------
---------------
------ooo---oo-
-------y--Y--y-
XXXXXXXXXXXXXXX
XXXXXXXXXXXXXXX