---------------
---------------
---------------
---------------
---------------
---------------
---------------
---------------
----oooo-----g-
##--####--#####
-#-y#--#-y#----
--##----##-----
---------------
---------------
---------------
---------------